22222222222222222222
20000000000000000002
20000000000000000002
20000000000000000002
20000100000000100002
20001110000001110002
20000100000000100002
20000000000000000002
20000000000000000002
20000000022200000002
20000000022200000002
20000000000000000002
20000000000000000002
20000100000000100002
20001110000001110002
20000100000000100002
20000000000000000002
20000000000000000002
20000000000000000002
22222222222222222222